Niveau 2
EEEEEEEEEEEEEEEEEEEEEEEEE
EEEEE333335555533333EEEEE
EEEEEE3333355533333EEEEEE
EEEEEEE11111111111EEEEEEE
EEEEEEEEEEEEEEEEEEEEEEEEE
EEEE22222222222222222EEEE
EEEE222EEEEEEEEEEE222EEEE
EEEE222EEEEEEEEEEE222EEEE
EEEEEEEEEEEEEEEEEEEEEEEEE
EEEEEEEEEEEEEEEEEEEEEEEEE
EEEEEEEEEEEEEEEEEEEEEEEEE
EEEEEEEEEEEEEEEEEEEEEEEEE
EEEEEEEEEEEEEEEEEEEEEEEEE
EEEEEEEEEEEEEEEEEEEEEEEEE
EEEEEEEEEEEEEEEEEEEEEEEEE
EEEEEEEEEEEEEEEEEEEEEEEEE
EEEEEEEEEEEEEEEEEEEEEEEEE
EEEEEEEEEEEEEEEEEEEEEEEEE
EEXXEEEEXXEEEEEXXEEEEXXEE
EEXXEEEEXXEEEEEXXEEEEXXEE
EEEEEEEEEEEEEEEEEEEEEEEEE
EEEEEEEEEEEEEEEEEEEEEEEEE
EEEEEEEEEEEESEEEEEEEEEEEE
EEEEEEEEEEEEEEEEEEEEEEEEE