Niveau 3
EEEEEEEEEEEEEEEEEEEEEEEEE
EEEEEEEEEEEE7EEEEEEEEEEEE
EEEE77111113331111177EEEE
EEEEEEE22244444222EEEEEEE
EEEEEE5662222222665EEEEEE
EEEEEEEEEE44444EEEEEEEEEE
EEEEEEEEEEEE5EEEEEEEEEEEE
EEEE66666EEEEEEEEEEEEEEEE
EEEE55555EEEEEEEE333EEEEE
EEEE44444EEEEEEEEEEEEEEEE
EEEEEEEEEEEEEEEEEEEEEEEEE
EEEEEEEEEEEEEE2EEEEEEEEEE
EEEEEEEEEEEEEEEEEEEEEEEEE
EEEEEEEEEEEEEEEEEEEEEEEEE
EEXXEEEEXXEEEEEXXEEEEXXEE
EEXXEEEEXXEEEEEXXEEEEXXEE
EEEEEEEEEEEEEEEEEEEEEEEEE
EEEEEEEEEEEEEEEEEEEEEEEEE
EEXXEEEEXXEEEEEXXEEEEXXEE
EEXXEEEEXXEEEEEXXEEEEXXEE
EEEEEEEEEEEEEEEEEEEEEEEEE
EEEEEEEEEEEEEEEEEEEEEEEEE
EEEEEEEEEEEESEEEEEEEEEEEE
EEEEEEEEEEEEEEEEEEEEEEEEE