Niveau 1
EEEEEEEEEEEEEEEEEEEEEEEEE
EEEEE222222222222222EEEEE
EEEEE111111111111111EEEEE
EEEEE111111111111111EEEEE
EEEEEEEEEEE2E2EEEEEEEEEEE
EEEEEEEEEEEE2EEEEEEEEEEEE
EEEEEEEEEEEEEEEEEEEEEEEEE
EEEEEEEEEEEEEEEEEEEEEEEEE
EEEEEEEEEEEEEEEEEEEEEEEEE
EEEEEEEEEEEEEEEEEEEEEEEEE
EEEEEEEEEEEEEEEEEEEEEEEEE
EEEEEEEEEEEEEEEEEEEEEEEEE
EEEEEEEEEEEEEEEEEEEEEEEEE
EEEEEEEEEEEEEEEEEEEEEEEEE
EEEEEEEEEEEEEEEEEEEEEEEEE
EEEEEEEEEEEEEEEEEEEEEEEEE
EEEEEEEEEEEEEEEEEEEEEEEEE
EEEEEEEEEEEEEEEEEEEEEEEEE
EEXXEEEEXXEEEEEXXEEEEXXEE
EEXXEEEEXXEEEEEXXEEEEXXEE
EEEEEEEEEEEEEEEEEEEEEEEEE
EEEEEEEEEEEEEEEEEEEEEEEEE
EEEEEEEEEEEESEEEEEEEEEEEE
EEEEEEEEEEEEEEEEEEEEEEEEE
