Niveau 2
EEEEEEEEEEEEEEEEEEEEEEEEE
EEEEEEEEEEEE7EEEEEEEEEEEE
EEEEEE1111133311111EEEEEE
EEEEEEE22244444222EEEEEEE
EEEEEE5662222222665EEEEEE
EEEEEEEEEE44444EEEEEEEEEE
EEEEEEEEEEEE5EEEEEEEEEEEE
EEEEEEEEEEEEEEEEEEEEEEEEE
EEEEEEEEEEEEEEEEEEEEEEEEE
EEEEEEEEEEEEEEEEEEEEEEEEE
EEEEEEEEEEEEEEEEEEEEEEEEE
EEEEEEEEEEEEEEEEEEEEEEEEE
EEEEEEEEEEEEEEEEEEEEEEEEE
EEEEEEEEEEEEEEEEEEEEEEEEE
EEEEEEEEEEEEEEEEEEEEEEEEE
EEEEEEEEEEEEEEEEEEEEEEEEE
EEEEEEEEEEEEEEEEEEEEEEEEE
EEEEEEEEEEEEEEEEEEEEEEEEE
EEXXEEEEXXEEEEEXXEEEEXXEE
EEXXEEEEXXEEEEEXXEEEEXXEE
EEEEEEEEEEEEEEEEEEEEEEEEE
EEEEEEEEEEEEEEEEEEEEEEEEE
EEEEEEEEEEEESEEEEEEEEEEEE
EEEEEEEEEEEEEEEEEEEEEEEEE