Niveau 5
EEEEEEEEEEEEEEEEEEEEEEEEE
EEE22222EEE646EEE22222EEE
EEED33333EEE4EEE33333DEEE
EEEEE55555EE4EE55555EEEEE
EEEEEE77777EEE77777EEEEEE
EEEEEEEEEEE555EEEEEEEEEEE
EEEEE111112222211111EEEEE
EEEEEE2222EEEEE2222EEEEEE
EEEEEEEE33EEEEE33EEEEEEEE
EEEEEEEEEEEE7EEEEEEEEEEEE
EEEE6E6EEEEEDEEEEE6E6EEEE
EEEEE6E6EEEEEEEEE6E6EEEEE
EEEEEDEEEEEEEEEEEEEDEEEEE
EEEEEEEEEEEEEEEEEEEEEEEEE
EEEXXEEEEEEEEEEEEEEEXXEEE
EEEEEEEEEEEEEEEEEEEEEEEEE
EEEEEEEEEEEEEEEEEEEEEEEEE
EEEEEEEEEEEEEEEEEEEEEEEEE
EEEEEEEEEEEEEEEEEEEEEEEEE
EEEEEEEEEEEEXEEEEEEEEEEEE
EEEXXEEEEEEEXEEEEEEEXXEEE
EEXEEXEEEEEEEEEEEEEXEEXEE
EEEEEEEEEEEESEEEEEEEEEEEE
EEEEEEEEEEEEEEEEEEEEEEEEE