Niveau 4
EEEEEEEEEEEEEEEEEEEEEEEEE
EEE22222EEE646EEE22222EEE
EEEE33333EEE4EEE33333EEEE
EEEEE55555EE4EE55555EEEEE
EEEEEE77777EEE77777EEEEEE
EEEEEEEEEEEEEEEEEEEEEEEEE
EEEEE11111EEEEE11111EEEEE
EEEEEE2222EEEEE2222EEEEEE
EEEEEEEE33EEEEE33EEEEEEEE
EEEEEEEEEEEE7EEEEEEEEEEEE
EEEE6E6EEEEEEEEEEE6E6EEEE
EEEEE6E6EEEEEEEEE6E6EEEEE
EEEEEEEEEEEEEEEEEEEEEEEEE
EEEEEEEEEEEEEEEEEEEEEEEEE
EEEXXEEEEEEEEEEEEEEEXXEEE
EEEEEEEEEEEEEEEEEEEEEEEEE
EEEEEEEEEEEEEEEEEEEEEEEEE
EEEEEEEEEEEEEEEEEEEEEEEEE
EEEEEEEEEEEEEEEEEEEEEEEEE
EEEEEEEEEEEEXEEEEEEEEEEEE
EEEXXEEEEEEEXEEEEEEEXXEEE
EEXEEXEEEEEEEEEEEEEXEEXEE
EEEEEEEEEEEESEEEEEEEEEEEE
EEEEEEEEEEEEEEEEEEEEEEEEE