EEEEEEEEEEEEEEEEEEEEEEEEE
EEEEEEEEEEEEEEEEEEEEEEEEE
EEEEEEEEEEEEEEEEEEEEEEEEE
EEEEEE7EEEEEEEEEEEEEEEEEE
11111E33111E1EEEEEEEEEEEE
E2224E444E2EEEEEEEEEEEEEE
56622E222E6EEEEEEEEEEEEEE
EEEE4E44EEEEEEEEEEEEEEEEE
EEEEEE5EEEEEEEEEEEEEEEEEE
EEEEEEEEEEEEEEEEEEEEEEEEE
EEEEEEEEEEEEEEEEEEEEEEEEE
EEEEEEEEEEEEEEEEEEEEEEEEE
EEEEEEEEEEEEEEEEEEEEEEEEE
EEEEEEEEEEEEEEEEEEEEEEEEE
EEEEEEEEEEEEEEEEEEEEEEEEE
EEEEEEEEEEEEEEEEEEEEEEEEE
EEEEEEEEEEEEEEEEEEEEEEEEE
EEEEEEEEEEEEEEEEEEEEEEEEE
EEOOEEEEOOEEEEEOOEEEEOOEE
EEOOEEEEOOEEEEEOOEEEEOOEE
EEEEEEEEEEEEEEEEEEEEEEEEE
EEEEEEEEEEEEEEEEEEEEEEEEE
EEEEEEEEEEESEEEEEEEEEEEEE
EEEEEEEEEEEEEEEEEEEEEEEEE

