test.txt
EEEEEEEEEEEEEEEEEEEEEEE
EEEEEEEEEEEEEEEEEEEEEEE
EEEEEEEEE1111111111111E
EEEEEEEEE111E111111111E
EEEEEEEEE11EEE11111111E
EEEEEEEEEEEEEEEEEEEEEEE
EEEEEEEEEEEEEEEEEEEEEEE
EEEEEEEEEEEEEEEEEEEEEEE
EEEEEEEEEEEEEEEEEEEEEEE
EEEEEEEEEEEEEEEEEEEEEEE
EEEEEEEEEEEEEEEEEEEEEEE
EEEEEEEEEEEEEEEEEDEEEEE
EEEEEEEEEEEEEEEEEEEEEEE
EEEEEEEEEEEEEEEEEEEEEEE
EEEEEEEEEEEEEEEEEEEEEEE
EEEEEEEEEEEEEEEEEEEEEEE
EEEEEEEEEEEEEEEEEEEEEEE
EXXEEEEXXEEBEEXXEEEEXXE
EXXEEEEXXEEEEEXXEEEEXXE
EEEEEEEEEEEEEEEEEEEEEEE
EEEEEEEEEEESEEEEEEEEEEE
EEEEEEEEEEEEEEEEEEEEEEE
